BatchNum	0
Nsims	1
Nreps	5
Years	51
PatchModel	1
MaxHabitats	3
SpeciesDist	0
DistResolution	-9
StageStruct	1
Stages	5
Repro	1
Temp_dep	0
Size_or_Time	1
Growth_file	-9
Grow_Method	-9
dyn_land	0
LandFile	LandFile_0.txt
dyn_landfile	NULL
InitialisationFile	InitFile.txt
PopulationFile	PopFile.txt
Stagestructfile	StagestructFile.txt
EmigrationFile	EmigFile.txt
TransferFile	TransFile.txt
SettlementFile	SettFile.txt
EvolutionFile	EvolutionFile.txt
Outpop	1
OutInd	1
OutIndMov	0
Outrange	1
Outpop_int	10
OutInd_int	10
OutRange_int	10
